107
8
22 4 0 0 0 0 0 0 0 0 0 0 0 0 0 0 0 0
22 4 0 0 0 0 0 21 0 0 0 0 0 0 0 9 22 0
22 4 0 0 0 0 21 22 0 0 0 0 0 0 0 9 22 0
22 4 0 0 0 21 22 22 0 0 0 0 0 0 0 9 22 0
22 4 0 0 21 22 22 22 0 0 0 0 0 0 0 9 22 0
22 4 0 21 22 22 22 22 0 0 0 0 0 0 0 0 0 0
22 4 21 22 22 22 22 22 0 0 0 0 0 0 0 0 21 0
5  21 22 22 22 22 22 22 0 0 0 0 0 0 0 0 22 22
